0,0,0,0,0,0,0,0,0,0,0,0,0,0,0,0,0,0,0,0
0,0,0,0,0,0,0,0,0,0,0,0,0,0,0,0,0,0,0,0
0,0,0,0,0,0,0,0,0,0,0,0,0,0,0,0,0,0,0,0
0,0,0,0,0,0,0,0,0,0,0,0,0,0,0,0,0,0,0,0
0,0,0,0,0,0,0,0,0,0,0,0,0,0,0,0,0,0,0,0
0,0,0,0,0,0,0,0,0,0,0,0,0,0,0,0,0,0,0,0
0,0,0,0,0,0,0,0,0,0,0,0,0,0,0,0,0,0,0,0
0,0,0,0,0,0,0,0,0,0,0,0,0,0,0,0,0,0,0,0
0,0,0,0,0,0,0,0,0,0,0,0,0,0,0,0,0,0,0,0
7,8,0,6,8,0,0,0,0,0,0,0,0,0,0,0,0,0,0,0
13,13,7,13,13,7,8,0,0,0,0,0,0,0,0,0,0,0,0,0
13,13,13,13,13,13,20,0,9,9,9,0,0,0,0,0,0,0,0,0
19,19,19,19,19,20,0,0,0,0,0,0,6,7,7,7,7,7,7,7
0,0,0,0,0,0,0,0,0,0,0,6,13,13,13,13,13,13,13,13
0,0,0,0,0,0,0,0,0,0,6,13,13,13,13,13,13,13,13,13
0,0,0,0,0,0,0,0,0,6,13,13,13,13,13,13,13,13,13,13
0,0,0,0,0,0,0,0,6,13,13,13,13,13,13,13,13,13,13,13
0,0,0,0,0,0,0,6,13,13,13,13,13,13,13,13,13,13,13,13
1,1,1,1,1,1,6,13,13,13,13,13,13,13,13,13,13,13,13,13
7,7,7,7,7,7,13,13,13,13,13,13,13,13,13,13,13,13,13,13
